<MAP LENGHT>
50 50
<MAP TILES>
0 25 26 27 28 0 29 0 27 26 0 25 0 27 28 29 56 25 0 26 0 29 0 25 26 0 28 27 0 25 0 26 0 29 0 25 0 28 0 29 0 26 27 0 29 28 26 0 0 0
27 28 29 54 25 26 0 27 25 55 28 29 0 25 0 0 26 0 0 27 55 0 28 0 0 29 54 25 0 26 0 27 0 29 0 25 0 26 0 29 0 28 0 27 0 0 0 0 0 0
25 53 52 2 2 2 2 2 2 2 2 2 2 2 2 2 2 4 6 0 25 55 0 25 26 27 56 0 25 55 0 56 0 26 27 0 27 55 0 56 0 0 25 0 55 0 29 28 27 0
0 51 1 1 1 1 1 1 1 1 1 1 1 1 1 1 1 1 17 0 26 25 0 28 0 54 0 29 25 26 0 27 54 0 25 26 0 27 28 29 0 0 55 25 27 29 0 56 0 29
26 33 1 1 1 1 1 1 1 1 1 1 1 1 1 1 1 1 18 29 28 56 25 25 26 27 28 0 54 0 28 29 27 25 26 29 0 29 54 25 27 28 29 0 56 0 0 28 26 29
27 50 1 1 1 1 1 1 1 1 1 1 1 1 1 1 1 1 37 36 29 28 0 55 25 26 0 56 27 28 25 26 27 54 0 25 29 29 25 26 0 56 0 25 26 27 28 0 29 0
0 49 48 3 3 3 5 1 1 1 1 1 31 3 5 1 1 1 1 35 2 2 2 2 2 2 2 2 2 2 2 2 2 2 2 2 2 2 2 2 2 2 2 4 6 0 55 0 29 0
25 26 0 27 0 28 7 9 1 1 1 32 30 0 7 9 1 1 1 1 1 1 1 1 1 1 1 1 1 1 1 1 1 1 1 1 1 1 1 1 1 1 1 1 17 0 25 26 0 28
27 26 40 41 0 29 28 33 1 1 1 34 25 29 0 10 1 1 1 1 1 1 1 1 1 1 1 1 1 1 1 1 1 1 1 1 1 1 1 1 1 1 1 1 34 25 0 56 26 27
28 0 42 43 0 26 25 33 1 1 1 34 25 28 26 10 1 1 1 1 1 1 1 1 1 1 1 1 1 1 1 1 1 1 1 1 1 1 1 1 1 1 1 1 34 0 25 26 27 29
0 29 0 29 0 27 13 11 1 1 1 37 36 27 13 11 1 1 1 31 3 3 3 3 3 5 1 1 1 1 1 31 3 3 3 3 3 3 3 3 5 1 1 1 34 0 29 28 54 28
26 53 52 2 2 2 14 1 1 1 1 1 35 15 14 1 1 1 32 30 0 0 0 0 0 7 9 1 1 1 32 30 0 28 29 25 0 26 0 25 7 9 1 1 34 25 26 0 28 29
29 51 1 1 1 1 1 1 1 1 1 1 1 1 1 1 1 1 34 25 26 28 29 25 29 29 33 1 1 1 34 28 29 26 0 27 0 40 41 25 29 33 1 1 34 0 28 29 27 25
0 33 1 1 1 1 1 1 1 1 1 1 1 1 1 1 1 1 19 26 29 28 54 27 25 29 33 1 1 1 34 0 0 55 25 0 25 42 43 0 0 33 1 1 34 0 25 27 0 29
27 50 1 1 1 1 1 1 1 1 1 1 1 1 1 1 1 1 20 26 25 27 29 0 29 0 33 1 1 1 34 29 25 26 27 28 29 0 0 25 26 33 1 1 34 26 0 55 25 26
25 49 48 3 3 3 5 1 1 1 1 1 31 3 3 3 3 23 24 0 0 0 40 41 0 0 33 1 1 1 34 25 26 27 29 0 56 25 26 0 29 33 1 1 34 26 27 0 29 0
28 27 26 25 28 29 7 9 1 1 1 32 30 25 26 0 29 28 29 25 26 0 42 43 0 0 33 1 1 1 34 25 26 27 40 41 28 29 25 26 27 33 1 1 34 25 26 0 56 28
29 54 26 28 55 29 0 33 1 1 1 34 27 26 25 28 29 27 25 29 28 0 29 25 26 0 33 1 1 1 34 29 28 0 42 43 0 29 25 26 27 33 1 1 34 29 28 27 0 26
29 26 25 27 26 25 29 33 1 1 1 34 25 26 27 55 0 28 29 25 26 27 29 56 28 29 33 1 1 1 34 29 0 28 27 26 0 25 27 26 25 33 1 1 34 28 0 55 26 25
26 40 41 27 28 29 0 33 1 1 1 34 0 26 27 0 28 29 40 41 29 28 29 27 25 26 33 1 1 1 34 0 54 29 28 0 29 25 26 27 0 33 1 1 34 29 28 0 27 25
25 42 43 27 28 26 25 33 1 1 1 34 0 26 25 26 25 26 42 43 27 28 29 28 27 26 33 1 1 1 34 29 28 27 26 25 0 29 0 28 29 33 1 1 34 0 25 26 56 27
26 27 28 29 0 29 28 33 1 1 1 34 25 27 29 28 0 29 28 0 29 27 25 26 27 28 33 1 1 1 34 25 26 28 29 28 29 40 41 28 29 33 1 1 34 0 25 0 28 29
25 54 27 29 28 55 29 33 1 1 1 34 0 0 40 41 25 0 26 25 29 29 0 28 27 27 33 1 1 1 34 25 0 0 55 26 27 42 43 26 25 33 1 1 34 0 26 0 27 28
28 29 25 56 27 29 28 33 1 1 1 34 0 0 42 43 26 27 0 29 0 29 56 0 25 26 33 1 1 1 34 25 0 26 27 0 28 29 29 25 0 33 1 1 34 0 27 28 0 29
27 0 26 25 26 25 29 33 1 1 1 34 0 0 0 0 0 0 0 0 54 25 29 28 27 26 33 1 1 1 34 25 0 27 0 26 25 56 26 0 25 33 1 1 34 26 25 56 0 29
25 55 26 27 28 0 13 11 1 1 1 37 36 25 26 27 0 28 29 28 25 26 0 27 29 13 11 1 1 1 37 36 25 26 27 28 29 29 26 0 13 11 1 1 37 36 0 28 27 0
2 2 2 2 2 2 14 1 1 1 1 1 35 15 2 2 2 2 2 2 2 2 2 2 2 14 1 1 1 1 1 35 2 2 2 2 2 2 2 2 14 1 1 1 1 35 15 2 2 2
44 45 1 44 45 1 1 1 1 1 1 1 44 45 1 44 45 1 44 45 1 44 45 1 44 45 1 1 1 1 1 1 44 45 1 44 45 1 44 45 1 1 1 1 1 44 45 1 44 45
46 47 1 46 47 1 1 1 1 1 1 1 46 47 1 46 47 1 46 47 1 46 47 1 46 47 1 1 1 1 1 1 46 47 1 46 47 1 46 47 1 1 1 1 1 46 47 1 46 47
1 1 1 1 1 1 1 1 1 1 1 1 1 1 1 1 1 1 1 1 1 1 1 1 1 1 1 1 1 1 1 1 1 1 1 1 1 1 1 1 1 1 1 1 1 1 1 1 1 1
44 45 1 1 1 1 1 1 1 1 1 1 1 1 1 1 1 1 1 1 1 1 1 1 1 1 1 1 1 1 1 1 1 1 1 1 1 1 1 1 1 1 1 1 1 1 1 1 1 1
46 47 1 1 1 1 1 1 1 1 1 1 1 1 1 1 1 1 1 1 1 1 1 1 1 1 1 1 1 1 1 1 1 1 1 1 1 1 1 1 1 1 1 1 1 1 1 1 1 1
1 1 1 1 1 1 1 1 1 1 1 1 1 1 1 1 1 1 1 1 1 1 1 1 1 1 1 1 1 1 1 1 1 1 1 1 1 1 1 1 1 1 1 1 1 1 1 1 1 1
44 45 1 44 45 1 1 1 1 1 1 1 1 1 1 44 45 1 44 45 1 44 45 1 44 45 1 44 45 1 44 45 1 44 45 1 44 45 1 44 45 1 44 45 1 44 45 1 44 45
46 47 1 46 47 1 1 1 1 1 1 1 1 1 1 46 47 1 46 47 1 46 47 1 46 47 1 46 47 1 46 47 1 46 47 1 46 47 1 46 47 1 46 47 1 46 47 1 46 47
3 3 3 3 3 3 5 1 1 1 1 1 1 1 31 3 3 3 3 3 3 3 3 3 3 3 3 3 3 3 3 3 3 3 3 3 3 3 3 3 3 3 3 3 3 3 3 3 3 3
28 26 0 28 29 28 7 9 1 1 1 1 1 32 30 0 25 26 0 27 0 29 0 28 29 25 26 0 26 27 28 0 29 0 25 26 27 28 0 29 25 27 26 29 28 0 29 0 29 28
27 25 54 26 0 28 29 33 1 1 1 1 1 34 0 26 27 29 28 29 25 54 0 26 27 28 0 29 55 25 26 0 27 0 29 54 27 0 28 55 29 28 26 25 29 0 29 28 27 0
29 25 27 29 28 29 13 11 1 1 1 1 1 37 36 0 28 0 29 0 25 26 0 27 25 26 27 0 28 29 0 29 0 25 26 27 28 29 0 28 27 25 56 25 26 27 0 29 0 28
28 53 52 2 2 2 14 1 1 1 1 1 1 1 35 15 2 2 2 2 2 2 2 2 2 2 2 2 2 2 2 2 2 2 2 2 4 6 27 29 28 0 0 29 28 55 29 0 0 28
27 51 44 45 1 44 45 1 1 1 1 1 1 1 44 45 1 44 45 1 44 45 1 44 45 1 44 45 1 44 45 1 44 45 1 44 45 17 0 27 28 0 29 54 26 25 0 26 0 27
28 33 46 47 1 46 47 1 1 1 1 1 1 1 46 47 1 46 47 1 46 47 1 46 47 1 46 47 1 46 47 1 46 47 1 46 47 34 27 0 55 27 26 0 25 56 26 0 27 29
29 33 44 45 1 1 1 1 1 1 1 1 1 1 1 1 1 1 1 1 1 1 1 1 1 1 1 1 1 1 1 1 1 1 1 44 45 34 25 26 0 27 28 0 29 0 25 0 26 29
29 33 46 47 1 1 1 1 1 1 1 1 1 1 1 1 1 1 1 1 1 1 1 1 1 1 1 1 1 1 1 1 1 1 1 46 47 34 25 0 29 0 28 27 25 26 0 28 29 27
28 33 44 45 1 44 45 1 44 45 1 44 45 1 44 45 1 44 45 1 44 45 1 44 45 1 44 45 1 44 45 1 44 45 1 44 45 19 27 28 0 29 0 56 25 26 27 0 54 28
27 50 46 47 1 46 47 1 46 47 1 46 47 1 46 47 1 46 47 1 46 47 1 46 47 1 46 47 1 46 47 1 46 47 1 46 47 20 25 0 55 26 27 0 28 54 29 28 27 0
26 49 48 3 3 3 3 3 3 3 3 3 3 3 3 3 3 3 3 3 3 3 3 3 3 3 3 3 3 3 3 3 3 3 3 3 23 24 0 28 0 29 0 26 27 29 28 25 26 27
26 25 26 28 29 0 25 26 27 28 29 27 28 29 25 24 25 26 27 28 29 28 25 25 26 27 0 28 29 27 25 29 25 26 27 28 0 29 27 28 29 54 25 26 28 29 27 25 26 29
25 54 29 28 27 28 55 29 27 28 25 26 27 28 0 29 54 27 26 29 27 26 29 28 25 55 29 29 28 29 0 28 56 29 28 27 26 25 29 28 56 29 28 29 25 26 27 29 0 28
26 27 28 25 26 27 25 26 27 0 28 29 56 28 29 27 26 25 26 29 25 56 26 25 29 28 29 25 26 54 0 29 29 28 27 25 27 29 55 29 28 29 27 26 54 25 26 29 28 29
<MAP OVERLAY>
-1 -1 -1 -1 -1 -1 -1 -1 -1 -1 -1 -1 -1 -1 -1 -1 -1 -1 -1 -1 -1 -1 -1 -1 -1 -1 -1 -1 -1 -1 -1 -1 -1 -1 -1 -1 -1 -1 -1 -1 -1 -1 -1 -1 -1 -1 -1 -1 -1 -1
-1 -1 -1 -1 -1 -1 -1 -1 -1 -1 -1 -1 -1 -1 -1 -1 -1 -1 -1 -1 -1 -1 -1 -1 -1 -1 -1 -1 -1 -1 -1 -1 -1 -1 -1 -1 -1 -1 -1 -1 -1 -1 -1 -1 -1 -1 -1 -1 -1 -1
-1 -1 -1 -1 -1 -1 -1 -1 -1 -1 -1 -1 -1 -1 -1 -1 -1 -1 -1 -1 -1 -1 -1 -1 -1 -1 -1 -1 -1 -1 -1 -1 -1 -1 -1 -1 -1 -1 -1 -1 -1 -1 -1 -1 -1 -1 -1 -1 -1 -1
-1 -1 -1 -1 -1 -1 -1 -1 -1 -1 -1 -1 -1 -1 -1 -1 -1 -1 -1 -1 -1 -1 -1 -1 -1 -1 -1 -1 -1 -1 -1 -1 -1 -1 -1 -1 -1 -1 -1 -1 -1 -1 -1 -1 -1 -1 -1 -1 -1 -1
-1 -1 -1 -1 -1 -1 -1 -1 -1 -1 -1 -1 -1 -1 -1 -1 -1 -1 -1 -1 -1 -1 -1 -1 -1 -1 -1 -1 -1 -1 -1 -1 -1 -1 -1 -1 -1 -1 -1 -1 -1 -1 -1 -1 -1 -1 -1 -1 -1 -1
-1 -1 -1 -1 -1 -1 -1 -1 -1 -1 -1 -1 -1 -1 -1 -1 -1 -1 -1 -1 -1 -1 -1 -1 -1 -1 -1 -1 -1 -1 -1 -1 -1 -1 -1 -1 -1 -1 -1 -1 -1 -1 -1 -1 -1 -1 -1 -1 -1 -1
-1 -1 -1 -1 -1 -1 -1 -1 -1 -1 -1 -1 -1 -1 -1 -1 -1 -1 -1 -1 -1 -1 -1 -1 -1 -1 -1 -1 -1 -1 -1 -1 -1 -1 -1 -1 -1 -1 -1 -1 -1 -1 -1 -1 -1 -1 -1 -1 -1 -1
-1 -1 -1 -1 -1 -1 -1 -1 -1 -1 -1 -1 -1 -1 -1 -1 -1 -1 -1 -1 -1 -1 -1 -1 -1 -1 -1 -1 -1 -1 -1 -1 -1 -1 -1 -1 -1 -1 -1 -1 -1 -1 -1 -1 -1 -1 -1 -1 -1 -1
-1 -1 -1 -1 -1 -1 -1 -1 -1 -1 -1 -1 -1 -1 -1 -1 -1 -1 -1 -1 -1 -1 -1 -1 -1 -1 -1 -1 -1 -1 -1 -1 -1 -1 -1 -1 -1 -1 -1 -1 -1 -1 -1 -1 -1 -1 -1 -1 -1 -1
-1 -1 -1 -1 -1 -1 -1 -1 -1 -1 -1 -1 -1 -1 -1 -1 -1 -1 -1 -1 -1 -1 -1 -1 -1 -1 -1 -1 -1 -1 -1 -1 -1 -1 -1 -1 -1 -1 -1 -1 -1 -1 -1 -1 -1 -1 -1 -1 -1 -1
-1 -1 -1 -1 -1 -1 -1 -1 -1 -1 -1 -1 -1 -1 -1 -1 -1 -1 -1 -1 -1 -1 -1 -1 -1 -1 -1 -1 -1 -1 -1 -1 -1 -1 -1 -1 -1 -1 -1 -1 -1 -1 -1 -1 -1 -1 -1 -1 -1 -1
-1 -1 -1 -1 -1 -1 -1 -1 -1 -1 -1 -1 -1 -1 -1 -1 -1 -1 -1 -1 -1 -1 -1 -1 -1 -1 -1 -1 -1 -1 -1 -1 -1 -1 -1 -1 -1 -1 -1 -1 -1 -1 -1 -1 -1 -1 -1 -1 -1 -1
-1 -1 -1 -1 -1 -1 -1 -1 -1 -1 -1 -1 -1 -1 -1 -1 -1 -1 -1 -1 -1 -1 -1 -1 -1 -1 -1 -1 -1 -1 -1 -1 -1 -1 -1 -1 -1 -1 -1 -1 -1 -1 -1 -1 -1 -1 -1 -1 -1 -1
-1 -1 -1 -1 -1 -1 -1 -1 -1 -1 -1 -1 -1 -1 -1 -1 -1 -1 -1 -1 -1 -1 -1 -1 -1 -1 -1 -1 -1 -1 -1 -1 -1 -1 -1 -1 -1 -1 -1 -1 -1 -1 -1 -1 -1 -1 -1 -1 -1 -1
-1 -1 -1 -1 -1 -1 -1 -1 -1 -1 -1 -1 -1 -1 -1 -1 -1 -1 -1 -1 -1 -1 -1 -1 -1 -1 -1 -1 -1 -1 -1 -1 -1 -1 -1 -1 -1 -1 -1 -1 -1 -1 -1 -1 -1 -1 -1 -1 -1 -1
-1 -1 -1 -1 -1 -1 -1 -1 -1 -1 -1 -1 -1 -1 -1 -1 -1 -1 -1 -1 -1 -1 -1 -1 -1 -1 -1 -1 -1 -1 -1 -1 -1 -1 -1 -1 -1 -1 -1 -1 -1 -1 -1 -1 -1 -1 -1 -1 -1 -1
-1 -1 -1 -1 -1 -1 -1 -1 -1 -1 -1 -1 -1 -1 -1 -1 -1 -1 -1 -1 -1 -1 -1 -1 -1 -1 -1 -1 -1 -1 -1 -1 -1 -1 -1 -1 -1 -1 -1 -1 -1 -1 -1 -1 -1 -1 -1 -1 -1 -1
-1 -1 -1 -1 -1 -1 -1 -1 -1 -1 -1 -1 -1 -1 -1 -1 -1 -1 -1 -1 -1 -1 -1 -1 -1 -1 -1 -1 -1 -1 -1 -1 -1 -1 -1 -1 -1 -1 -1 -1 -1 -1 -1 -1 -1 -1 -1 -1 -1 -1
-1 -1 -1 -1 -1 -1 -1 -1 -1 -1 -1 -1 -1 -1 -1 -1 -1 -1 -1 -1 -1 -1 -1 -1 -1 -1 -1 -1 -1 -1 -1 -1 -1 -1 -1 -1 -1 -1 -1 -1 -1 -1 -1 -1 -1 -1 -1 -1 -1 -1
-1 -1 -1 -1 -1 -1 -1 -1 -1 -1 -1 -1 -1 -1 -1 -1 -1 -1 -1 -1 -1 -1 -1 -1 -1 -1 -1 -1 -1 -1 -1 -1 -1 -1 -1 -1 -1 -1 -1 -1 -1 -1 -1 -1 -1 -1 -1 -1 -1 -1
-1 -1 -1 -1 -1 -1 -1 -1 -1 -1 -1 -1 -1 -1 -1 -1 -1 -1 -1 -1 -1 -1 -1 -1 -1 -1 -1 -1 -1 -1 -1 -1 -1 -1 -1 -1 -1 -1 -1 -1 -1 -1 -1 -1 -1 -1 -1 -1 -1 -1
-1 -1 -1 -1 -1 -1 -1 -1 -1 -1 -1 -1 -1 -1 -1 -1 -1 -1 -1 -1 -1 -1 -1 -1 -1 -1 -1 -1 -1 -1 -1 -1 -1 -1 -1 -1 -1 -1 -1 -1 -1 -1 -1 -1 -1 -1 -1 -1 -1 -1
-1 -1 -1 -1 -1 -1 -1 -1 -1 -1 -1 -1 -1 -1 -1 -1 -1 -1 -1 -1 -1 -1 -1 -1 -1 -1 -1 -1 -1 -1 -1 -1 -1 -1 -1 -1 -1 -1 -1 -1 -1 -1 -1 -1 -1 -1 -1 -1 -1 -1
-1 -1 -1 -1 -1 -1 -1 -1 -1 -1 -1 -1 -1 -1 -1 -1 -1 -1 -1 -1 -1 -1 -1 -1 -1 -1 -1 -1 -1 -1 -1 -1 -1 -1 -1 -1 -1 -1 -1 -1 -1 -1 -1 -1 -1 -1 -1 -1 -1 -1
-1 -1 -1 -1 -1 -1 -1 -1 -1 -1 -1 -1 -1 -1 -1 -1 -1 -1 -1 -1 -1 -1 -1 -1 -1 -1 -1 -1 -1 -1 -1 -1 -1 -1 -1 -1 -1 -1 -1 -1 -1 -1 -1 -1 -1 -1 -1 -1 -1 -1
-1 -1 -1 -1 -1 -1 -1 -1 -1 -1 -1 -1 -1 -1 -1 -1 -1 -1 -1 -1 -1 -1 -1 -1 -1 -1 -1 -1 -1 -1 -1 -1 -1 -1 -1 -1 -1 -1 -1 -1 -1 -1 -1 -1 -1 -1 -1 -1 -1 -1
-1 -1 -1 -1 -1 -1 -1 -1 -1 -1 -1 -1 -1 -1 -1 -1 -1 -1 -1 -1 -1 -1 -1 -1 -1 -1 -1 -1 -1 -1 -1 -1 -1 -1 -1 -1 -1 -1 -1 -1 -1 -1 -1 -1 -1 -1 -1 -1 -1 -1
-1 -1 -1 -1 -1 -1 -1 -1 -1 -1 -1 -1 -1 -1 -1 -1 -1 -1 -1 -1 -1 -1 -1 -1 -1 -1 -1 -1 -1 -1 -1 -1 -1 -1 -1 -1 -1 -1 -1 -1 -1 -1 -1 -1 -1 -1 -1 -1 -1 -1
-1 -1 -1 -1 -1 -1 -1 -1 -1 -1 -1 -1 -1 -1 -1 -1 -1 -1 -1 -1 -1 -1 -1 -1 -1 -1 -1 -1 -1 -1 -1 -1 -1 -1 -1 -1 -1 -1 -1 -1 -1 -1 -1 -1 -1 -1 -1 -1 -1 -1
-1 -1 -1 -1 -1 -1 -1 -1 -1 -1 -1 -1 -1 -1 -1 -1 -1 -1 -1 -1 -1 -1 -1 -1 -1 -1 -1 -1 -1 -1 -1 -1 -1 -1 -1 -1 -1 -1 -1 -1 -1 -1 -1 -1 -1 -1 -1 -1 -1 -1
-1 -1 -1 -1 -1 -1 -1 -1 -1 -1 -1 -1 -1 -1 -1 -1 -1 -1 -1 -1 -1 -1 -1 -1 -1 -1 -1 -1 -1 -1 -1 -1 -1 -1 -1 -1 -1 -1 -1 -1 -1 -1 -1 -1 -1 -1 -1 -1 -1 -1
-1 -1 -1 -1 -1 -1 -1 -1 -1 -1 -1 -1 -1 -1 -1 -1 -1 -1 -1 -1 -1 -1 -1 -1 -1 -1 -1 -1 -1 -1 -1 -1 -1 -1 -1 -1 -1 -1 -1 -1 -1 -1 -1 -1 -1 -1 -1 -1 -1 -1
-1 -1 -1 -1 -1 -1 -1 -1 -1 -1 -1 -1 -1 -1 -1 -1 -1 -1 -1 -1 -1 -1 -1 -1 -1 -1 -1 -1 -1 -1 -1 -1 -1 -1 -1 -1 -1 -1 -1 -1 -1 -1 -1 -1 -1 -1 -1 -1 -1 -1
-1 -1 -1 -1 -1 -1 -1 -1 -1 -1 -1 -1 -1 -1 -1 -1 -1 -1 -1 -1 -1 -1 -1 -1 -1 -1 -1 -1 -1 -1 -1 -1 -1 -1 -1 -1 -1 -1 -1 -1 -1 -1 -1 -1 -1 -1 -1 -1 -1 -1
-1 -1 -1 -1 -1 -1 -1 -1 -1 -1 -1 -1 -1 -1 -1 -1 -1 -1 -1 -1 -1 -1 -1 -1 -1 -1 -1 -1 -1 -1 -1 -1 -1 -1 -1 -1 -1 -1 -1 -1 -1 -1 -1 -1 -1 -1 -1 -1 -1 -1
-1 -1 -1 -1 -1 -1 -1 -1 -1 -1 -1 -1 -1 -1 -1 -1 -1 -1 -1 -1 -1 -1 -1 -1 -1 -1 -1 -1 -1 -1 -1 -1 -1 -1 -1 -1 -1 -1 -1 -1 -1 -1 -1 -1 -1 -1 -1 -1 -1 -1
-1 -1 -1 -1 -1 -1 -1 -1 -1 -1 -1 -1 -1 -1 -1 -1 -1 -1 -1 -1 -1 -1 -1 -1 -1 -1 -1 -1 -1 -1 -1 -1 -1 -1 -1 -1 -1 -1 -1 -1 -1 -1 -1 -1 -1 -1 -1 -1 -1 -1
-1 -1 -1 -1 -1 -1 -1 -1 -1 -1 -1 -1 -1 -1 -1 -1 -1 -1 -1 -1 -1 -1 -1 -1 -1 -1 -1 -1 -1 -1 -1 -1 -1 -1 -1 -1 -1 -1 -1 -1 -1 -1 -1 -1 -1 -1 -1 -1 -1 -1
-1 -1 -1 -1 -1 -1 -1 -1 -1 -1 -1 -1 -1 -1 -1 -1 -1 -1 -1 -1 -1 -1 -1 -1 -1 -1 -1 -1 -1 -1 -1 -1 -1 -1 -1 -1 -1 -1 -1 -1 -1 -1 -1 -1 -1 -1 -1 -1 -1 -1
-1 -1 -1 -1 -1 -1 -1 -1 -1 -1 -1 -1 -1 -1 -1 -1 -1 -1 -1 -1 -1 -1 -1 -1 -1 -1 -1 -1 -1 -1 -1 -1 -1 -1 -1 -1 -1 -1 -1 -1 -1 -1 -1 -1 -1 -1 -1 -1 -1 -1
-1 -1 -1 -1 -1 -1 -1 -1 -1 -1 -1 -1 -1 -1 -1 -1 -1 -1 -1 -1 -1 -1 -1 -1 -1 -1 -1 -1 -1 -1 -1 -1 -1 -1 -1 -1 -1 -1 -1 -1 -1 -1 -1 -1 -1 -1 -1 -1 -1 -1
-1 -1 -1 -1 -1 -1 -1 -1 -1 -1 -1 -1 -1 -1 -1 -1 -1 -1 -1 -1 -1 -1 -1 -1 -1 -1 -1 -1 -1 -1 -1 -1 -1 -1 -1 -1 -1 -1 -1 -1 -1 -1 -1 -1 -1 -1 -1 -1 -1 -1
-1 -1 -1 -1 -1 -1 -1 -1 -1 -1 -1 -1 -1 -1 -1 -1 -1 -1 -1 -1 -1 -1 -1 -1 -1 -1 -1 -1 -1 -1 -1 -1 -1 -1 -1 -1 -1 -1 -1 -1 -1 -1 -1 -1 -1 -1 -1 -1 -1 -1
-1 -1 -1 -1 -1 -1 -1 -1 -1 -1 -1 -1 -1 -1 -1 -1 -1 -1 -1 -1 -1 -1 -1 -1 -1 -1 -1 -1 -1 -1 -1 -1 -1 -1 -1 -1 -1 -1 -1 -1 -1 -1 -1 -1 -1 -1 -1 -1 -1 -1
-1 -1 -1 -1 -1 -1 -1 -1 -1 -1 -1 -1 -1 -1 -1 -1 -1 -1 -1 -1 -1 -1 -1 -1 -1 -1 -1 -1 -1 -1 -1 -1 -1 -1 -1 -1 -1 -1 -1 -1 -1 -1 -1 -1 -1 -1 -1 -1 -1 -1
-1 -1 -1 -1 -1 -1 -1 -1 -1 -1 -1 -1 -1 -1 -1 -1 -1 -1 -1 -1 -1 -1 -1 -1 -1 -1 -1 -1 -1 -1 -1 -1 -1 -1 -1 -1 -1 -1 -1 -1 -1 -1 -1 -1 -1 -1 -1 -1 -1 -1
-1 -1 -1 -1 -1 -1 -1 -1 -1 -1 -1 -1 -1 -1 -1 -1 -1 -1 -1 -1 -1 -1 -1 -1 -1 -1 -1 -1 -1 -1 -1 -1 -1 -1 -1 -1 -1 -1 -1 -1 -1 -1 -1 -1 -1 -1 -1 -1 -1 -1
-1 -1 -1 -1 -1 -1 -1 -1 -1 -1 -1 -1 -1 -1 -1 -1 -1 -1 -1 -1 -1 -1 -1 -1 -1 -1 -1 -1 -1 -1 -1 -1 -1 -1 -1 -1 -1 -1 -1 -1 -1 -1 -1 -1 -1 -1 -1 -1 -1 -1
-1 -1 -1 -1 -1 -1 -1 -1 -1 -1 -1 -1 -1 -1 -1 -1 -1 -1 -1 -1 -1 -1 -1 -1 -1 -1 -1 -1 -1 -1 -1 -1 -1 -1 -1 -1 -1 -1 -1 -1 -1 -1 -1 -1 -1 -1 -1 -1 -1 -1
-1 -1 -1 -1 -1 -1 -1 -1 -1 -1 -1 -1 -1 -1 -1 -1 -1 -1 -1 -1 -1 -1 -1 -1 -1 -1 -1 -1 -1 -1 -1 -1 -1 -1 -1 -1 -1 -1 -1 -1 -1 -1 -1 -1 -1 -1 -1 -1 -1 -1
<COINS>
1
10 15
<HERO POS>
3 4
<SNAKES>
15
8 5
10 33
18 42
25 30
15 10
25 8
40 8
38 29
10 35
28 15
28 23
42 15
42 23
10 13
4 12
<HEARTS>
9
8 4
9 30
25 43
30 30
20 8
30 8
42 8
45 30
10 40
<ENEMIES>
1
10 30 1



