<MAP LENGHT>
50 50
<MAP TILES>
0 0 0 0 0 0 0 0 0 0 0 0 0 0 0 0 0 0 0 0 33 1 1 1 1 34 0 0 0 0 0 0 0 0 33 1 1 1 1 34 0 0 0 0 0 0 0 0 0 0
0 0 0 0 0 0 0 0 0 0 0 0 0 0 0 0 0 0 0 0 33 1 1 1 1 34 0 0 0 0 0 0 0 0 33 1 1 1 1 34 0 0 0 0 0 0 0 0 0 0
0 0 0 0 0 0 0 0 0 0 0 0 0 0 0 0 0 0 0 0 33 1 1 1 1 34 0 0 0 0 0 0 0 0 33 1 1 1 1 34 0 0 0 0 0 0 0 0 0 0
0 0 0 0 0 0 0 0 0 0 0 0 0 0 0 0 0 0 0 0 33 1 1 1 1 34 0 0 0 0 0 0 0 0 33 1 1 1 1 34 0 0 0 0 0 0 0 0 0 0
0 0 0 0 0 0 0 0 0 0 0 0 0 0 0 0 0 0 0 13 11 1 1 1 1 37 36 0 0 0 0 0 0 13 11 1 1 1 1 37 36 0 0 0 0 0 0 0 0 0
2 2 2 2 2 2 2 2 2 2 2 2 2 2 2 2 2 2 2 14 1 1 1 1 1 1 35 2 2 2 2 2 2 14 1 1 1 1 1 1 35 2 2 2 2 2 2 2 2 2
1 1 1 1 1 1 1 1 1 1 1 1 1 1 1 1 1 1 1 1 1 1 1 1 1 1 1 1 1 1 1 1 1 1 1 1 1 1 1 1 1 1 1 1 1 1 1 1 1 1
1 1 1 1 1 1 1 1 1 1 1 1 1 1 1 1 1 1 1 1 1 1 1 1 1 1 1 1 1 1 1 1 1 1 1 1 1 1 1 1 1 1 1 1 1 1 1 1 1 1
1 1 1 1 1 1 1 1 1 1 1 1 1 1 1 1 1 1 1 1 1 1 1 1 1 1 1 1 1 1 1 1 1 1 1 1 1 1 1 1 1 1 1 1 1 1 1 1 1 1
3 3 3 3 3 3 3 3 3 3 3 5 1 1 1 1 1 31 3 3 3 3 3 3 3 3 3 3 3 3 3 3 3 3 3 3 5 1 1 1 1 31 3 3 3 3 3 3 3 3
0 0 0 0 0 0 0 0 0 0 0 7 9 1 1 1 32 30 0 0 0 0 0 0 0 0 0 0 0 0 0 0 0 0 0 0 7 9 1 1 32 30 0 0 0 0 0 0 0 0
0 0 0 0 0 0 0 0 0 0 0 0 33 1 1 1 34 0 0 0 0 0 0 0 0 0 0 0 0 0 0 0 0 0 0 0 0 33 1 1 34 0 0 0 0 0 0 0 0 0
0 0 0 0 0 0 0 0 0 0 0 13 11 1 1 1 37 36 0 0 0 0 0 0 0 0 0 0 0 0 0 0 0 0 0 0 0 33 1 1 34 0 0 0 0 0 0 0 0 0
0 0 53 52 2 2 2 2 2 2 2 14 1 1 1 1 1 35 15 2 2 2 2 2 2 2 2 2 2 4 6 0 0 0 0 0 0 33 1 1 34 0 0 0 0 0 0 0 0 0
0 0 51 1 1 1 1 1 1 1 1 1 1 1 1 1 1 1 1 1 1 1 1 1 1 1 1 1 1 1 17 0 0 0 0 0 0 33 1 1 34 0 0 0 0 0 0 0 0 0
0 0 33 1 1 1 1 1 1 1 1 1 1 1 1 1 1 1 1 1 1 1 1 1 1 1 1 1 1 1 34 0 0 0 0 0 0 33 1 1 34 0 0 0 0 0 0 0 0 0
0 0 33 1 1 1 1 1 1 1 1 1 1 1 1 1 1 1 1 1 1 1 1 1 1 1 1 1 1 1 34 0 0 0 0 0 0 33 1 1 34 0 0 0 0 0 0 0 0 0
0 0 33 1 1 1 1 1 1 1 1 1 1 1 1 1 1 1 1 1 1 1 1 1 1 1 1 1 1 1 34 0 0 0 0 0 0 33 1 1 34 0 0 0 0 0 0 0 0 0
0 0 33 1 1 1 1 1 1 1 1 1 1 1 1 1 1 1 1 1 1 1 1 1 1 1 1 1 1 1 19 0 0 0 0 0 0 33 1 1 34 0 0 0 0 0 0 0 0 0
0 0 50 1 1 1 1 1 1 1 1 1 1 1 1 1 1 1 1 1 1 1 1 1 1 1 1 1 1 1 20 0 0 0 0 0 0 33 1 1 34 0 0 0 0 0 0 0 0 0
0 0 49 48 3 3 3 3 3 3 3 3 5 1 1 1 1 1 1 31 3 3 3 3 3 3 3 3 3 23 24 0 0 0 0 0 0 33 1 1 34 0 0 0 0 0 0 0 0 0
0 0 0 0 0 0 0 0 0 0 0 0 7 9 1 1 1 1 32 30 0 0 0 0 0 0 0 0 0 0 0 0 0 0 0 0 0 33 1 1 34 0 0 0 0 0 0 0 0 0
0 0 0 0 0 0 0 0 0 0 0 0 0 33 1 1 1 1 34 0 0 0 0 0 0 0 0 0 0 0 0 0 0 0 0 0 0 33 1 1 34 0 0 0 0 0 0 0 0 0
0 0 0 0 0 0 0 0 0 0 0 0 13 11 1 1 1 1 37 36 0 0 0 0 0 0 0 0 0 0 0 0 0 0 0 0 13 11 1 1 37 36 0 0 0 0 0 0 0 0
2 2 2 2 2 2 2 2 2 2 2 2 14 1 1 1 1 1 1 35 15 2 2 2 2 2 2 2 2 2 2 2 2 2 2 2 14 1 1 1 1 35 15 2 4 6 0 0 0 0
1 1 1 1 1 1 1 1 1 1 1 1 1 1 1 1 1 1 1 1 1 1 1 1 1 1 1 1 1 1 1 1 1 1 1 1 1 1 1 1 1 1 1 1 1 17 0 0 0 0
1 1 1 1 1 1 1 1 1 1 1 1 1 1 1 1 1 1 1 1 1 1 1 1 1 1 1 1 1 1 1 1 1 1 1 1 1 1 1 1 1 1 1 1 1 34 0 0 0 0
1 1 1 1 1 1 1 1 1 1 1 1 1 1 1 1 1 1 1 1 1 1 1 1 1 31 3 3 3 3 5 1 1 1 1 1 1 31 3 3 3 5 1 1 1 34 0 0 0 0
1 1 1 1 1 1 1 1 1 1 1 1 1 1 1 1 1 1 1 1 1 1 1 1 32 30 0 0 0 0 7 9 1 1 1 1 32 30 0 0 0 7 9 1 1 34 0 0 0 0
1 1 1 1 1 31 3 3 3 3 3 3 5 1 1 1 1 1 1 1 1 1 1 1 34 0 0 0 0 0 0 10 1 1 1 1 34 0 0 0 0 0 10 1 1 34 0 0 0 0
1 1 1 1 32 30 0 0 0 0 0 0 7 9 1 1 1 1 1 1 1 1 1 1 34 0 0 0 0 0 0 10 1 1 1 1 37 36 0 0 0 13 11 1 1 19 0 0 0 0
1 1 1 1 34 0 0 0 0 0 0 0 0 10 1 1 1 1 1 1 1 1 1 1 37 36 0 0 0 0 13 11 1 1 1 1 1 35 2 2 15 14 1 1 1 19 0 0 0 0
1 1 1 1 34 0 0 0 0 0 0 0 0 10 1 1 1 1 1 1 1 1 1 1 1 35 2 2 15 2 14 1 1 1 1 1 1 1 1 1 1 1 1 1 1 19 0 0 0 0
1 1 1 1 37 36 0 0 0 0 0 0 13 11 1 1 1 1 1 1 1 1 1 1 1 1 1 1 1 1 1 1 1 1 1 1 1 1 1 1 1 1 1 1 1 34 0 0 0 0
1 1 1 1 1 35 2 2 2 15 2 2 14 1 1 1 1 1 1 1 1 1 1 1 1 1 1 1 1 1 1 1 1 1 1 1 1 1 1 1 1 1 1 1 1 34 0 0 0 0
1 1 1 1 1 1 1 1 1 1 1 1 1 1 1 1 1 1 1 1 1 1 1 1 1 1 1 1 1 1 1 1 1 1 1 1 1 1 1 1 1 1 1 1 1 20 0 0 0 0
3 3 3 3 3 3 3 3 3 3 3 3 3 3 3 3 3 3 3 3 3 3 3 3 3 3 3 3 3 3 3 3 3 3 3 3 3 3 3 3 3 3 3 3 23 24 0 0 0 0
0 0 0 0 0 0 0 0 0 0 0 0 0 0 0 0 0 0 0 0 0 0 0 0 0 0 0 0 0 0 0 0 0 0 0 0 0 0 0 0 0 0 0 0 0 0 0 0 0 0
0 0 0 0 0 0 0 0 0 0 0 0 0 0 0 0 0 0 0 0 0 0 0 0 0 0 0 0 0 0 0 0 0 0 0 0 0 0 0 0 0 0 0 0 0 0 0 0 0 0
0 0 0 0 0 0 0 0 0 0 0 0 0 0 0 0 0 0 0 0 0 0 0 0 0 0 0 0 0 0 0 0 0 0 0 0 0 0 0 0 0 0 0 0 0 0 0 0 0 0
0 0 0 0 0 0 0 0 0 0 0 0 0 0 0 0 0 0 0 0 0 0 0 0 0 0 0 0 0 0 0 0 0 0 0 0 0 0 0 0 0 0 0 0 0 0 0 0 0 0
0 0 0 0 0 0 0 0 0 0 0 0 0 0 0 0 0 0 0 0 0 0 0 0 0 0 0 0 0 0 0 0 0 0 0 0 0 0 0 0 0 0 0 0 0 0 0 0 0 0
0 0 0 0 0 0 0 0 0 0 0 0 0 0 0 0 0 0 0 0 0 0 0 0 0 0 0 0 0 0 0 0 0 0 0 0 0 0 0 0 0 0 0 0 0 0 0 0 0 0
0 0 0 0 0 0 0 0 0 0 0 0 0 0 0 0 0 0 0 0 0 0 0 0 0 0 0 0 0 0 0 0 0 0 0 0 0 0 0 0 0 0 0 0 0 0 0 0 0 0
0 0 0 0 0 0 0 0 0 0 0 0 0 0 0 0 0 0 0 0 0 0 0 0 0 0 0 0 0 0 0 0 0 0 0 0 0 0 0 0 0 0 0 0 0 0 0 0 0 0
0 0 0 0 0 0 0 0 0 0 0 0 0 0 0 0 0 0 0 0 0 0 0 0 0 0 0 0 0 0 0 0 0 0 0 0 0 0 0 0 0 0 0 0 0 0 0 0 0 0
0 0 0 0 0 0 0 0 0 0 0 0 0 0 0 0 0 0 0 0 0 0 0 0 0 0 0 0 0 0 0 0 0 0 0 0 0 0 0 0 0 0 0 0 0 0 0 0 0 0
0 0 0 0 0 0 0 0 0 0 0 0 0 0 0 0 0 0 0 0 0 0 0 0 0 0 0 0 0 0 0 0 0 0 0 0 0 0 0 0 0 0 0 0 0 0 0 0 0 0
0 0 0 0 0 0 0 0 0 0 0 0 0 0 0 0 0 0 0 0 0 0 0 0 0 0 0 0 0 0 0 0 0 0 0 0 0 0 0 0 0 0 0 0 0 0 0 0 0 0
0 0 0 0 0 0 0 0 0 0 0 0 0 0 0 0 0 0 0 0 0 0 0 0 0 0 0 0 0 0 0 0 0 0 0 0 0 0 0 0 0 0 0 0 0 0 0 0 0 0
<MAP OVERLAY>
-1 -1 -1 57 58 59 59 60 60 59 58 59 60 59 57 58 57 58 59 -1 -1 -1 -1 -1 -1 -1 57 59 60 58 57 58 57 -1 -1 -1 -1 -1 -1 -1 57 60 58 57 58 60 60 57 60 58
57 57 57 -1 57 60 57 60 57 60 57 57 57 60 57 60 57 57 57 -1 -1 -1 -1 -1 -1 -1 57 59 60 58 57 58 57 -1 -1 -1 -1 -1 -1 -1 57 60 58 57 58 60 60 57 60 58
-1 57 -1 57 60 -57 57 57 60 57 -1 57 -1 57 -1 57 57 57 -1 -1 -1 -1 -1 -1 -1 -1 57 59 60 58 57 58 57 -1 -1 -1 -1 -1 -1 -1 57 60 58 57 58 60 60 57 60 58
57 57 57 57 -60 57 57 57 -57 57 -1 57 57 -1 57 57 -1 57 57 -1 -1 -1 -1 -1 -1 -1 57 59 60 58 57 58 57 -1 -1 -1 -1 -1 -1 -1 57 60 58 57 58 60 60 57 60 58
-1 -1 -1 -1 -1 -1 -1 -1 -1 -1 -1 -1 -1 -1 -1 -1 -1 -1 -1 -1 -1 -1 -1 -1 -1 -1 -1 -1 -1 -1 -1 -1 -1 -1 -1 -1 -1 -1 -1 -1 -1 -1 -1 -1 -1 -1 -1 -1 -1 -1
-1 -1 -1 -1 -1 -1 -1 -1 -1 -1 -1 -1 -1 -1 -1 -1 -1 -1 -1 -1 -1 -1 -1 -1 -1 -1 -1 -1 -1 -1 -1 -1 -1 -1 -1 -1 -1 -1 -1 -1 -1 -1 -1 -1 -1 -1 -1 -1 -1 -1
-1 -1 -1 -1 -1 -1 -1 -1 -1 -1 -1 -1 -1 -1 -1 -1 -1 -1 -1 -1 -1 -1 -1 -1 -1 -1 -1 -1 -1 -1 -1 -1 -1 -1 -1 -1 -1 -1 -1 -1 -1 -1 -1 -1 -1 -1 -1 -1 -1 -1
-1 -1 -1 -1 -1 -1 -1 -1 -1 -1 -1 -1 -1 -1 -1 -1 -1 -1 -1 -1 -1 -1 -1 -1 -1 -1 -1 -1 -1 -1 -1 -1 -1 -1 -1 -1 -1 -1 -1 -1 -1 -1 -1 -1 -1 -1 -1 -1 -1 -1
-1 -1 -1 -1 -1 -1 -1 -1 -1 -1 -1 -1 -1 -1 -1 -1 -1 -1 -1 -1 -1 -1 -1 -1 -1 -1 -1 -1 -1 -1 -1 -1 -1 -1 -1 -1 -1 -1 -1 -1 -1 -1 -1 -1 -1 -1 -1 -1 -1 -1
58 59 60 60 60 57 58 57 58 60 60 -1 -1 -1 -1 -1 -1 60 58 57 60 58 59 60 57 58 59 60 59 60 59 58 60 59 60 58 -1 -1 -1 -1 -1 58 58 59 60 58 59 60 60 58
-1 -1 -1 -1 -1 -1 -1 -1 -1 -1 -1 -1 -1 -1 -1 -1 -1 -1 -1 -1 -1 -1 -1 -1 -1 -1 -1 -1 -1 -1 -1 -1 -1 -1 -1 -1 -1 -1 -1 -1 -1 -1 -1 -1 -1 -1 -1 -1 -1 -1
58 59 60 60 60 57 58 57 58 60 60 -1 -1 -1 -1 -1 -1 60 58 57 60 58 59 60 57 58 59 60 59 60 59 58 60 59 60 58 -1 -1 -1 -1 -1 58 58 59 60 58 59 60 60 58
-1 -1 -1 -1 -1 -1 -1 -1 -1 -1 -1 -1 -1 -1 -1 -1 -1 -1 -1 -1 -1 -1 -1 -1 -1 -1 -1 -1 -1 -1 -1 -1 -1 -1 -1 -1 -1 -1 -1 -1 -1 -1 -1 -1 -1 -1 -1 -1 -1 -1
60 -1 -1 -1 -1 -1 -1 -1 -1 -1 -1 -1 -1 -1 -1 -1 -1 -1 -1 -1 -1 -1 -1 -1 -1 -1 -1 -1 -1 -1 -1 62 -1 -1 -1 62 -1 -1 -1 -1 -1 58 58 59 60 58 59 60 60 58
-1 -1 -1 -1 -1 -1 -1 -1 -1 -1 -1 -1 -1 -1 -1 -1 -1 -1 -1 -1 -1 -1 -1 -1 -1 -1 -1 -1 -1 -1 -1 61 -1 63 65 62 -1 -1 -1 -1 -1 -1 -1 -1 -1 -1 -1 -1 -1 -1
60 -1 -1 -1 -1 -1 -1 -1 -1 -1 -1 -1 -1 -1 -1 -1 -1 -1 -1 -1 -1 -1 -1 -1 -1 -1 -1 -1 -1 -1 -1 62 -1 64 66 61 -1 -1 -1 -1 -1 58 58 59 60 58 59 60 60 58
-1 -1 -1 -1 -1 -1 -1 -1 -1 -1 -1 -1 -1 -1 -1 -1 -1 -1 -1 -1 -1 -1 -1 -1 -1 -1 -1 -1 -1 -1 -1 62 61 61 61 62 -1 -1 -1 -1 -1 -1 -1 -1 -1 -1 -1 -1 -1 -1
58 -1 -1 -1 -1 -1 -1 -1 -1 -1 -1 -1 -1 -1 -1 -1 -1 -1 -1 -1 -1 -1 -1 -1 -1 -1 -1 -1 -1 -1 -1 61 61 -1 61 62 -1 -1 -1 -1 -1 58 58 59 60 58 59 60 60 58
-1 -1 -1 -1 -1 -1 -1 -1 -1 -1 -1 -1 -1 -1 -1 -1 -1 -1 -1 -1 -1 -1 -1 -1 -1 -1 -1 -1 -1 -1 -1 62 -1 61 61 61 -1 -1 -1 -1 -1 -1 -1 -1 -1 -1 -1 -1 -1 -1
60 -1 -1 -1 -1 -1 -1 -1 -1 -1 -1 -1 -1 -1 -1 -1 -1 -1 -1 -1 -1 -1 -1 -1 -1 -1 -1 -1 -1 -1 -1 61 61 61 -1 62 -1 -1 -1 -1 -1 58 58 59 60 58 59 60 60 58
60 58 59 59 60 60 60 60 60 60 60 60 -1 -1 -1 -1 -1 -1 -1 59 59 60 60 60 60 60 60 59 58 60 59 62 61 -1 61 61 -1 -1 -1 -1 -1 -1 -1 -1 -1 -1 -1 -1 -1 -1
-1 -1 -1 -1 -1 -1 -1 -1 -1 -1 -1 -1 -1 -1 -1 -1 -1 -1 -1 -1 -1 -1 -1 -1 -1 -1 -1 -1 -1 -1 -1 61 -1 61 -1 62 -1 -1 -1 -1 -1 58 58 59 60 58 59 60 60 58
59 58 59 60 60 60 60 60 60 60 60 60 -1 -1 -1 -1 -1 -1 -1 59 59 60 60 60 60 60 60 59 58 60 59 61 62 61 61 61 -1 -1 -1 -1 -1 -1 -1 -1 -1 -1 -1 -1 -1 -1
-1 -1 -1 -1 -1 -1 -1 -1 -1 -1 -1 -1 -1 -1 -1 -1 -1 -1 -1 -1 -1 -1 -1 -1 -1 -1 -1 -1 -1 -1 -1 -1 -1 -1 -1 -1 -1 -1 -1 -1 -1 -1 -1 -1 -1 59 58 59 59 58
-1 -1 -1 -1 -1 -1 -1 -1 -1 -1 -1 -1 -1 -1 -1 -1 -1 -1 -1 -1 -1 -1 -1 -1 -1 -1 -1 -1 -1 -1 -1 -1 -1 -1 -1 -1 -1 -1 -1 -1 -1 -1 -1 -1 -1 -1 -1 -1 -1 -1
-1 -1 -1 -1 -1 -1 -1 -1 -1 -1 -1 -1 -1 -1 -1 -1 -1 -1 -1 -1 -1 -1 -1 -1 -1 -1 -1 -1 -1 -1 -1 -1 -1 -1 -1 -1 -1 -1 -1 -1 -1 -1 -1 -1 -1 -1 58 59 59 58
-1 -1 -1 -1 -1 -1 -1 -1 -1 -1 -1 -1 -1 -1 -1 -1 -1 -1 -1 -1 -1 -1 -1 -1 -1 -1 -1 -1 -1 -1 -1 -1 -1 -1 -1 -1 -1 -1 -1 -1 -1 -1 -1 -1 -1 -1 -1 -1 -1 -1
-1 -1 -1 -1 -1 -1 -1 -1 -1 -1 -1 -1 -1 -1 -1 -1 -1 -1 -1 -1 -1 -1 -1 -1 -1 60 -1 60 -1 61 -1 -1 -1 -1 -1 -1 -1 60 60 60 60 -1 -1 -1 -1 -1 58 59 59 58
-1 -1 -1 -1 -1 -1 -1 -1 -1 -1 -1 -1 -1 -1 -1 -1 -1 -1 -1 -1 -1 -1 -1 -1 -1 -1 67 -1 67 -1 -1 -1 -1 -1 -1 -1 -1 -1 67 -1 -1 -1 -1 -1 -1 -1 -1 -1 -1 -1
-1 -1 -1 -1 -1 59 61 -1 60 -1 60 62 -1 -1 -1 -1 -1 -1 -1 -1 -1 -1 -1 -1 -1 -1 61 -1 60 -1 62 -1 -1 -1 -1 -1 -1 61 61 61 61 -1 -1 -1 -1 -1 58 59 59 58
-1 -1 -1 -1 -1 -1 60 -1 -1 61 -1 -1 -1 -1 -1 -1 -1 -1 -1 -1 -1 -1 -1 -1 -1 60 -1 60 -1 61 -1 -1 -1 -1 -1 -1 -1 -1 -1 -1 -1 -1 -1 -1 -1 -1 -1 -1 -1 -1
-1 -1 -1 -1 -1 60 -1 60 -1 62 -1 60 -1 -1 -1 -1 -1 -1 -1 -1 -1 -1 -1 -1 -1 -1 -1 -1 -1 -1 -1 -1 -1 -1 -1 -1 -1 -1 -1 -1 -1 -1 -1 -1 -1 -1 58 59 59 58
-1 -1 -1 -1 -1 -1 62 -1 61 -1 60 -1 -1 -1 -1 -1 -1 -1 -1 -1 -1 -1 -1 -1 -1 -1 -1 -1 -1 -1 -1 -1 -1 -1 -1 -1 -1 -1 -1 -1 -1 -1 -1 -1 -1 -1 -1 -1 -1 -1
-1 -1 -1 -1 -1 -1 -1 -1 -1 -1 -1 -1 -1 -1 -1 -1 -1 -1 -1 -1 -1 -1 -1 -1 -1 -1 -1 -1 -1 -1 -1 -1 -1 -1 -1 -1 -1 -1 -1 -1 -1 -1 -1 -1 -1 -1 58 59 59 58
-1 -1 -1 -1 -1 -1 -1 -1 -1 -1 -1 -1 -1 -1 -1 -1 -1 -1 -1 -1 -1 -1 -1 -1 -1 -1 -1 -1 -1 -1 -1 -1 -1 -1 -1 -1 -1 -1 -1 -1 -1 -1 -1 -1 -1 -1 -1 -1 -1 -1
-1 -1 -1 -1 -1 -1 -1 -1 -1 -1 -1 -1 -1 -1 -1 -1 -1 -1 -1 -1 -1 -1 -1 -1 -1 -1 -1 -1 -1 -1 -1 -1 -1 -1 -1 -1 -1 -1 -1 -1 -1 -1 -1 -1 -1 -1 58 59 59 58
-1 -1 -1 -1 -1 -1 -1 -1 -1 -1 -1 -1 -1 -1 -1 -1 -1 -1 -1 -1 -1 -1 -1 -1 -1 -1 -1 -1 -1 -1 -1 -1 -1 -1 -1 -1 -1 -1 -1 -1 -1 -1 -1 -1 -1 -1 -1 -1 -1 -1
59 58 60 59 58 59 59 58 59 60 60 60 59 59 60 60 58 58 59 60 60 60 60 59 59 58 59 60 59 59 58 58 58 60 60 59 59 60 59 60 59 60 58 59 59 60 58 59 59 58
-1 -1 -1 -1 -1 -1 -1 -1 -1 -1 -1 -1 -1 -1 -1 -1 -1 -1 -1 -1 -1 -1 -1 -1 -1 -1 -1 -1 -1 -1 -1 -1 -1 -1 -1 -1 -1 -1 -1 -1 -1 -1 -1 -1 -1 -1 -1 -1 -1 -1
59 58 60 59 58 59 59 58 59 60 60 60 59 59 60 60 58 58 59 60 60 60 60 59 59 58 59 60 59 59 58 58 58 60 60 59 59 60 59 60 59 60 58 59 59 60 58 59 59 58
-1 -1 -1 -1 -1 -1 -1 -1 -1 -1 -1 -1 -1 -1 -1 -1 -1 -1 -1 -1 -1 -1 -1 -1 -1 -1 -1 -1 -1 -1 -1 -1 -1 -1 -1 -1 -1 -1 -1 -1 -1 -1 -1 -1 -1 -1 -1 -1 -1 -1
62 -1 61 -1 -1 -1 61 -1 61 -1 -1 -1 61 -1 61 -1 62 -1 61 -1 -1 61 -1 -1 -1 62 -1 61 -1 61 -1 62 -1 61 -1 61 -1 -1 62 -1 61 -1 62 -1 62 -1 -1 61 -1 61
-1 -1 -1 -1 -1 -1 -1 -1 -1 -1 -1 -1 -1 -1 -1 -1 -1 -1 -1 -1 -1 -1 -1 -1 -1 -1 -1 -1 -1 -1 -1 -1 -1 -1 -1 -1 -1 -1 -1 -1 -1 -1 -1 -1 -1 -1 -1 -1 -1 -1
-1 -1 -1 62 -1 -1 62 -1 -1 61 -1 61 -1 -1 61 -1 -1 62 -1 -1 61 -1 -1 61 -1 61 -1 61 -1 -1 62 -1 -1 61 -1 62 -1 61 -1 61 -1 62 -1 61 61 62 -1 -1 -1 61
-1 -1 -1 -1 -1 -1 -1 -1 -1 -1 -1 -1 -1 -1 -1 -1 -1 -1 -1 -1 -1 -1 -1 -1 -1 -1 -1 -1 -1 -1 -1 -1 -1 -1 -1 -1 -1 -1 -1 -1 -1 -1 -1 -1 -1 -1 -1 -1 -1 -1
-1 -1 -1 -1 -1 -1 -1 -1 -1 -1 -1 -1 -1 -1 -1 -1 -1 -1 -1 -1 -1 -1 -1 -1 -1 -1 -1 -1 -1 -1 -1 -1 -1 -1 -1 -1 -1 -1 -1 -1 -1 -1 -1 -1 -1 -1 -1 -1 -1 -1
-1 -1 -1 -1 -1 -1 -1 -1 -1 -1 -1 -1 -1 -1 -1 -1 -1 -1 -1 -1 -1 -1 -1 -1 -1 -1 -1 -1 -1 -1 -1 -1 -1 -1 -1 -1 -1 -1 -1 -1 -1 -1 -1 -1 -1 -1 -1 -1 -1 -1
-1 -1 -1 -1 -1 -1 -1 -1 -1 -1 -1 -1 -1 -1 -1 -1 -1 -1 -1 -1 -1 -1 -1 -1 -1 -1 -1 -1 -1 -1 -1 -1 -1 -1 -1 -1 -1 -1 -1 -1 -1 -1 -1 -1 -1 -1 -1 -1 -1 -1
-1 -1 -1 -1 -1 -1 -1 -1 -1 -1 -1 -1 -1 -1 -1 -1 -1 -1 -1 -1 -1 -1 -1 -1 -1 -1 -1 -1 -1 -1 -1 -1 -1 -1 -1 -1 -1 -1 -1 -1 -1 -1 -1 -1 -1 -1 -1 -1 -1 -1
-1 -1 -1 -1 -1 -1 -1 -1 -1 -1 -1 -1 -1 -1 -1 -1 -1 -1 -1 -1 -1 -1 -1 -1 -1 -1 -1 -1 -1 -1 -1 -1 -1 -1 -1 -1 -1 -1 -1 -1 -1 -1 -1 -1 -1 -1 -1 -1 -1 -1
<COINS>
16
10 15
4 15
15 25
18 20
10 8
21 4
38 1
22 4
36 2
1 33
3 25
39 32
37 25
23 15
15 15
15 29
<HERO POS>
1 7
<SNAKES>
22
10 5
15 22
16 14
18 18
21 1
35 1
40 6
35 6
2 33
1 28
10 25
1 24
17 25
12 25
10 13
5 15
24 15
26 18
17 30
20 31
35 32
39 33
<HEARTS>
14
4 6
10 25
20 16
16 18
23 1
37 1
43 7
48 7
39 20
40 25
25 25
25 35
15 34
2 33
<ENEMIES>
4
10 25 1
15 15 1
20 5 1
10 7 1