<MAP LENGHT>
50 50
<MAP TILES>
68 68 68 68 68 68 68 68 68 68 68 68 68 68 68 68 68 68 68 68 68 68 68 68 68 68 68 68 68 68 68 68 68 68 68 68 68 68 68 68 68 68 68 68 68 68 68 68 68 68
68 68 68 68 68 68 68 68 68 68 68 68 68 68 68 68 68 68 68 68 68 70 70 70 70 70 70 70 70 70 70 70 70 70 70 70 70 70 70 70 70 70 70 70 68 68 68 68 68 68
68 68 68 68 68 68 68 68 68 68 68 68 68 68 68 68 68 68 68 68 68 70 69 69 69 69 69 69 69 69 69 69 69 69 69 69 69 69 69 69 69 69 69 70 68 68 68 68 68 68
68 68 68 68 68 68 68 68 68 68 68 68 68 68 68 68 68 68 68 68 68 70 69 69 69 69 69 69 69 69 69 69 69 69 69 69 69 69 69 69 69 69 69 70 68 68 68 68 68 68
70 70 70 70 70 70 70 70 70 70 70 70 70 70 70 70 70 70 70 70 70 70 69 69 69 69 69 69 69 69 69 69 69 69 69 69 69 69 69 69 69 69 69 70 68 68 68 68 68 68
69 69 69 69 69 69 69 69 69 69 69 69 69 69 69 69 69 69 69 69 69 69 69 69 69 69 69 69 69 69 69 69 69 69 69 69 69 69 69 69 69 69 69 70 68 68 68 68 68 68
69 69 69 69 69 69 69 69 69 69 69 69 69 69 69 69 69 69 69 69 69 69 69 69 69 69 69 69 69 69 69 69 69 69 69 69 69 69 69 69 69 69 69 70 68 68 68 68 68 68
69 69 69 69 69 69 69 69 69 69 69 69 69 69 69 69 69 69 69 69 69 69 69 69 69 69 69 69 69 69 69 69 69 69 69 69 69 69 69 69 69 69 69 70 68 68 68 68 68 68
69 69 69 69 69 69 69 69 69 69 69 69 69 69 69 69 69 69 69 69 69 69 69 69 69 69 69 69 69 69 69 69 69 69 69 69 69 69 69 69 69 69 69 70 68 68 68 68 68 68
69 69 69 69 69 69 69 69 69 69 69 69 69 69 69 69 69 69 69 69 69 69 69 69 69 69 69 69 69 69 69 69 69 69 69 69 69 69 69 69 69 69 69 70 68 68 68 68 68 68
69 69 69 69 69 69 69 69 69 69 69 69 69 69 69 69 69 69 69 69 69 69 69 69 69 69 69 69 69 69 69 69 69 69 69 69 69 69 69 69 69 69 69 70 68 68 68 68 68 68
69 69 69 69 69 69 69 69 69 69 69 69 69 69 69 69 69 69 69 69 69 69 69 69 69 69 69 69 69 69 69 69 69 69 69 69 69 69 69 69 69 69 69 70 68 68 68 68 68 68
69 69 69 69 69 69 69 69 69 69 69 69 69 69 69 69 69 69 69 69 69 69 69 69 69 69 69 69 69 69 69 69 69 69 69 69 69 69 69 69 69 69 69 70 68 68 68 68 68 68
69 69 69 69 69 69 69 69 69 69 69 69 69 69 69 69 69 69 69 69 69 69 69 69 69 69 69 69 69 69 69 69 69 69 69 69 69 69 69 69 69 69 69 70 68 68 68 68 68 68
69 69 69 69 69 69 69 69 69 69 69 69 69 69 69 69 69 69 69 69 69 69 69 69 69 69 69 69 69 69 69 69 69 69 69 69 69 69 69 69 69 69 69 70 68 68 68 68 68 68
69 69 69 69 69 69 69 69 69 69 69 69 69 69 69 69 69 69 69 69 69 69 69 69 69 69 69 69 69 69 69 69 69 69 69 69 69 69 69 69 69 69 69 70 68 68 68 68 68 68
70 70 70 70 70 70 70 69 69 69 70 70 70 70 70 70 70 70 70 70 70 70 69 69 69 69 69 69 69 69 69 69 69 69 69 69 69 69 69 69 69 69 69 70 68 68 68 68 68 68
68 68 68 68 68 68 70 69 69 69 70 68 68 68 68 68 68 68 68 68 68 70 69 69 69 69 69 69 69 69 69 69 69 69 69 69 69 69 69 69 69 69 69 70 68 68 68 68 68 68
68 68 68 68 68 68 70 69 69 69 70 68 68 68 68 68 68 68 68 68 68 70 69 69 69 69 69 69 69 69 69 69 69 69 69 69 69 69 69 69 69 69 69 70 68 68 68 68 68 68
68 68 68 68 68 68 70 69 69 69 70 68 68 68 68 68 68 68 68 68 68 70 69 69 69 69 69 69 69 69 69 69 69 69 69 69 69 69 69 69 69 69 69 70 68 68 68 68 68 68
68 68 68 68 68 68 70 69 69 69 70 68 68 68 68 68 68 68 68 68 68 70 69 69 69 69 69 69 69 69 69 69 69 69 69 69 69 69 69 69 69 69 69 70 68 68 68 68 68 68
68 68 68 68 68 68 70 69 69 69 70 68 68 68 68 68 68 68 68 68 68 70 69 69 69 69 69 69 69 69 69 69 69 69 69 69 69 69 69 69 69 69 69 70 68 68 68 68 68 68
68 68 68 68 68 68 70 69 69 69 70 68 68 68 68 68 68 68 68 68 68 70 69 69 69 69 69 69 69 69 69 69 69 69 69 69 69 69 69 69 69 69 69 70 68 68 68 68 68 68
68 68 68 68 68 68 70 69 69 69 70 68 68 68 68 68 68 68 68 68 68 70 69 69 69 69 69 69 69 69 69 69 69 69 69 69 69 69 69 69 69 69 69 70 68 68 68 68 68 68
68 68 68 68 68 68 70 69 69 69 70 68 68 68 68 68 68 68 68 68 68 70 69 69 69 69 69 69 69 69 69 69 69 69 69 69 69 69 69 69 69 69 69 70 68 68 68 68 68 68
68 68 68 68 68 68 70 69 69 69 70 68 68 68 68 68 68 68 68 68 68 70 70 70 70 70 70 70 70 70 70 70 70 70 70 70 70 70 70 70 70 70 70 70 68 68 68 68 68 68
68 68 68 68 68 68 70 69 69 69 70 68 68 68 68 68 68 68 68 68 68 68 68 68 68 68 68 68 68 68 68 68 68 68 68 68 68 68 68 68 68 68 68 68 68 68 68 68 68 68
68 68 68 68 68 68 70 69 69 69 70 68 68 68 68 68 68 68 68 68 68 68 68 68 68 68 68 68 68 68 68 68 68 68 68 68 68 68 68 68 68 68 68 68 68 68 68 68 68 68
68 68 68 68 68 68 70 69 69 69 70 68 68 68 68 68 68 68 68 68 68 68 70 70 70 70 70 70 70 70 70 68 68 68 68 68 68 68 68 68 68 68 68 68 68 68 68 68 68 68
68 68 68 68 68 68 70 69 69 69 70 68 68 68 68 68 68 68 68 68 68 68 70 69 69 69 69 69 69 69 70 68 68 68 68 68 68 68 68 68 68 68 68 68 68 68 68 68 68 68
68 70 70 70 70 70 70 69 69 69 70 70 70 70 70 70 68 68 68 68 68 68 70 69 69 69 69 69 69 69 70 68 68 68 68 68 68 68 68 68 68 68 68 68 68 68 68 68 68 68
68 70 69 69 69 69 69 69 69 69 69 69 69 69 69 70 68 68 68 68 68 68 70 69 69 69 69 69 69 69 70 68 68 68 68 68 68 68 68 68 68 68 68 68 68 68 68 68 68 68
68 70 69 69 69 69 69 69 69 69 69 69 69 69 69 70 68 68 68 68 68 68 70 69 69 69 69 69 69 69 70 68 68 68 68 68 68 68 68 68 68 68 68 68 68 68 68 68 68 68
68 70 69 69 69 69 69 69 69 69 69 69 69 69 69 70 68 68 68 68 68 68 70 69 69 69 69 69 69 69 70 68 68 68 68 68 68 68 68 68 68 68 68 68 68 68 68 68 68 68
68 70 69 69 69 69 69 69 69 69 69 69 69 69 69 70 70 70 70 70 70 70 70 69 69 69 69 69 69 69 70 68 68 68 68 68 68 68 68 68 68 68 68 68 68 68 68 68 68 68
68 70 69 69 69 69 69 69 69 69 69 69 69 69 69 69 69 69 69 69 69 69 69 69 69 69 69 69 69 69 70 68 68 68 68 68 68 68 68 68 68 68 68 68 68 68 68 68 68 68
68 70 69 69 69 69 69 69 69 69 69 69 69 69 69 69 69 69 69 69 69 69 69 69 69 69 69 69 69 69 70 68 68 68 68 68 68 68 68 68 68 68 68 68 68 68 68 68 68 68
68 70 69 69 69 69 69 69 69 69 69 69 69 69 69 70 70 70 70 70 70 70 70 69 69 69 69 69 69 69 70 68 68 68 68 68 68 68 68 68 68 68 68 68 68 68 68 68 68 68
68 70 69 69 69 69 69 69 69 69 69 69 69 69 69 70 68 68 68 68 68 68 70 69 69 69 69 69 69 69 70 68 68 68 68 68 68 68 68 68 68 68 68 68 68 68 68 68 68 68
68 70 69 69 69 69 69 69 69 69 69 69 69 69 69 70 68 68 68 68 68 68 70 69 69 69 69 69 69 69 70 68 68 68 68 68 68 68 68 68 68 68 68 68 68 68 68 68 68 68
68 70 69 69 69 69 69 69 69 69 69 69 69 69 69 70 68 68 68 68 68 68 70 69 69 69 69 69 69 69 70 68 68 68 68 68 68 68 68 68 68 68 68 68 68 68 68 68 68 68
68 70 70 70 70 70 70 70 70 70 70 70 70 70 70 70 68 68 68 68 68 68 70 69 69 69 69 69 69 69 70 68 68 68 68 68 68 68 68 68 68 68 68 68 68 68 68 68 68 68
68 68 68 68 68 68 68 68 68 68 68 68 68 68 68 68 68 68 68 68 68 68 70 69 69 69 69 69 69 69 70 68 68 68 68 68 68 68 68 68 68 68 68 68 68 68 68 68 68 68
68 68 68 68 68 68 68 68 68 68 68 68 68 68 68 68 68 68 68 68 68 68 70 70 70 70 70 70 70 70 70 68 68 68 68 68 68 68 68 68 68 68 68 68 68 68 68 68 68 68
68 68 68 68 68 68 68 68 68 68 68 68 68 68 68 68 68 68 68 68 68 68 68 68 68 68 68 68 68 68 68 68 68 68 68 68 68 68 68 68 68 68 68 68 68 68 68 68 68 68
68 68 68 68 68 68 68 68 68 68 68 68 68 68 68 68 68 68 68 68 68 68 68 68 68 68 68 68 68 68 68 68 68 68 68 68 68 68 68 68 68 68 68 68 68 68 68 68 68 68
68 68 68 68 68 68 68 68 68 68 68 68 68 68 68 68 68 68 68 68 68 68 68 68 68 68 68 68 68 68 68 68 68 68 68 68 68 68 68 68 68 68 68 68 68 68 68 68 68 68
68 68 68 68 68 68 68 68 68 68 68 68 68 68 68 68 68 68 68 68 68 68 68 68 68 68 68 68 68 68 68 68 68 68 68 68 68 68 68 68 68 68 68 68 68 68 68 68 68 68
68 68 68 68 68 68 68 68 68 68 68 68 68 68 68 68 68 68 68 68 68 68 68 68 68 68 68 68 68 68 68 68 68 68 68 68 68 68 68 68 68 68 68 68 68 68 68 68 68 68
68 68 68 68 68 68 68 68 68 68 68 68 68 68 68 68 68 68 68 68 68 68 68 68 68 68 68 68 68 68 68 68 68 68 68 68 68 68 68 68 68 68 68 68 68 68 68 68 68 68
<MAP OVERLAY>
72 72 71 71 72 71 72 72 72 71 71 72 71 72 72 72 71 71 72 72 72 -1 -1 -1 -1 -1 -1 -1 -1 -1 -1 -1 -1 -1 -1 -1 -1 -1 -1 -1 -1 -1 -1 -1 -1 -1 -1 -1 -1 -1
71 72 71 72 72 72 71 72 71 72 71 71 71 72 71 71 72 72 72 71 -1 -1 -1 -1 -1 -1 -1 -1 -1 -1 -1 -1 -1 -1 -1 -1 -1 -1 -1 -1 -1 -1 -1 -1 72 -1 71 -1 -1 -1
72 71 72 71 72 72 71 72 71 72 71 72 71 72 71 71 72 72 72 72 74 73 -1 -1 -1 -1 -1 -1 -1 -1 -1 -1 -1 -1 -1 -1 -1 -1 -1 -1 -1 -1 -1 -1 -1 -1 -1 -1 -1 -1
-1 -1 -1 -1 -1 -1 -1 -1 -1 -1 -1 -1 -1 -1 -1 -1 -1 -1 -1 -1 -1 -1 -1 -1 -1 -1 -1 -1 -1 -1 -1 -1 -1 -1 -1 -1 -1 -1 -1 -1 -1 -1 -1 -1 -1 -1 72 -1 71 -1
-1 -1 -1 -1 -1 -1 -1 -1 -1 -1 -1 -1 -1 -1 -1 -1 -1 -1 -1 -1 -1 -1 -1 -1 -1 -1 -1 -1 -1 -1 -1 -1 -1 -1 -1 -1 -1 -1 -1 -1 -1 -1 -1 -1 -1 71 -1 72 -1 -1
-1 -1 -1 -1 -1 -1 -1 -1 -1 -1 -1 -1 -1 -1 -1 -1 -1 -1 -1 -1 -1 -1 -1 -1 -1 -1 -1 -1 -1 -1 -1 -1 -1 -1 -1 -1 -1 -1 -1 -1 -1 -1 -1 -1 -1 -1 -1 -1 -1 -1
-1 -1 -1 -1 -1 -1 -1 -1 -1 -1 -1 -1 -1 -1 -1 -1 -1 -1 -1 -1 -1 -1 -1 -1 -1 -1 -1 -1 -1 -1 -1 -1 -1 -1 -1 -1 -1 -1 -1 -1 -1 -1 -1 -1 -1 -1 71 -1 72 -1
-1 -1 -1 -1 -1 -1 -1 -1 -1 -1 -1 -1 -1 -1 -1 -1 -1 -1 -1 -1 -1 -1 -1 -1 -1 -1 -1 -1 -1 -1 -1 -1 -1 -1 -1 -1 -1 -1 -1 -1 -1 -1 -1 -1 -1 -1 -1 -1 -1 -1
-1 -1 -1 -1 -1 -1 -1 -1 -1 -1 -1 -1 -1 -1 -1 -1 -1 -1 -1 -1 -1 -1 -1 -1 -1 -1 -1 -1 -1 -1 -1 -1 -1 -1 -1 -1 -1 -1 -1 -1 -1 -1 -1 -1 -1 72 -1 -1 -1 -1
-1 -1 -1 -1 -1 -1 -1 -1 -1 -1 -1 -1 -1 -1 -1 -1 -1 -1 -1 -1 -1 -1 -1 -1 -1 -1 -1 -1 -1 -1 -1 -1 -1 -1 -1 -1 -1 -1 -1 -1 -1 -1 -1 -1 -1 -1 -1 -1 -1 -1
-1 -1 -1 -1 -1 -1 -1 -1 -1 -1 -1 -1 -1 -1 -1 -1 -1 -1 -1 -1 -1 -1 -1 -1 -1 -1 -1 -1 -1 -1 -1 -1 -1 -1 -1 -1 -1 -1 -1 -1 -1 -1 -1 -1 -1 -1 -1 -1 -1 -1
-1 -1 -1 -1 -1 -1 -1 -1 -1 -1 -1 -1 -1 -1 -1 -1 -1 -1 -1 -1 -1 -1 -1 -1 -1 -1 -1 -1 -1 -1 -1 -1 -1 -1 -1 -1 -1 -1 -1 -1 -1 -1 -1 -1 -1 -1 72 -1 -1 -1
-1 -1 -1 -1 -1 -1 -1 -1 -1 -1 -1 -1 -1 -1 -1 -1 -1 -1 -1 -1 -1 -1 -1 -1 -1 -1 -1 -1 -1 -1 -1 -1 -1 -1 -1 -1 -1 -1 -1 -1 -1 -1 -1 -1 -1 -1 -1 -1 -1 -1
-1 -1 -1 -1 -1 -1 -1 -1 -1 -1 -1 -1 -1 -1 -1 -1 -1 -1 -1 -1 -1 -1 -1 -1 -1 -1 -1 -1 -1 -1 -1 -1 -1 -1 -1 -1 -1 -1 -1 -1 -1 -1 -1 -1 -1 -1 -1 72 -1 -1
-1 -1 -1 -1 -1 -1 -1 -1 -1 -1 -1 -1 -1 -1 -1 -1 -1 -1 -1 -1 -1 -1 -1 -1 -1 -1 -1 -1 -1 -1 -1 -1 -1 -1 -1 -1 -1 -1 -1 -1 -1 -1 -1 -1 -1 72 -1 71 -1 -1
-1 -1 -1 -1 -1 -1 -1 -1 -1 -1 -1 -1 -1 -1 -1 -1 -1 -1 -1 -1 -1 -1 -1 -1 -1 -1 -1 -1 -1 -1 -1 -1 -1 -1 -1 -1 -1 -1 -1 -1 -1 -1 -1 -1 -1 -1 -1 -1 -1 -1
72 72 71 72 72 74 -1 -1 -1 -1 74 -1 72 71 72 72 71 72 72 71 74 73 -1 -1 -1 -1 -1 -1 -1 -1 -1 -1 -1 -1 -1 -1 -1 -1 -1 -1 -1 -1 -1 -1 72 -1 71 -1 -1 -1
71 72 71 71 72 -1 -1 -1 -1 -1 -1 -1 71 72 71 71 72 72 71 71 -1 -1 -1 -1 -1 -1 -1 -1 -1 -1 -1 -1 -1 -1 -1 -1 -1 -1 -1 -1 -1 -1 -1 -1 -1 -1 -1 -1 -1 -1
72 72 71 72 72 74 -1 -1 -1 -1 74 -1 72 71 72 72 71 72 72 71 72 -1 -1 -1 -1 -1 -1 -1 -1 -1 -1 -1 -1 -1 -1 -1 -1 -1 -1 -1 -1 -1 -1 -1 -1 -1 -1 72 -1 -1
72 72 71 72 72 -1 -1 -1 -1 -1 -1 -1 72 72 71 71 72 71 72 72 71 -1 -1 -1 -1 -1 -1 -1 -1 -1 -1 -1 -1 -1 -1 -1 -1 -1 -1 -1 -1 -1 -1 -1 -1 -1 -1 -1 -1 -1
72 71 72 71 71 74 -1 -1 -1 -1 74 -1 72 71 72 72 71 72 72 71 72 -1 -1 -1 -1 -1 -1 -1 -1 -1 -1 -1 -1 -1 -1 -1 -1 -1 -1 -1 -1 -1 -1 -1 -1 71 -1 -1 -1 -1
71 72 71 71 72 -1 -1 -1 -1 -1 -1 -1 72 71 72 72 71 72 72 71 72 -1 -1 -1 -1 -1 -1 -1 -1 -1 -1 -1 -1 -1 -1 -1 -1 -1 -1 -1 -1 -1 -1 -1 -1 -1 72 -1 -1 -1
72 72 71 72 72 74 -1 -1 -1 -1 74 -1 72 71 72 72 71 72 72 71 72 -1 -1 -1 -1 -1 -1 -1 -1 -1 -1 -1 -1 -1 -1 -1 -1 -1 -1 -1 -1 -1 -1 -1 -1 -1 -1 72 -1 -1
71 71 72 72 71 -1 -1 -1 -1 -1 -1 -1 72 72 71 71 72 71 72 72 71 -1 -1 -1 -1 -1 -1 -1 -1 -1 -1 -1 -1 -1 -1 -1 -1 -1 -1 -1 -1 -1 -1 -1 -1 72 -1 -1 -1 -1
72 71 72 71 71 74 -1 -1 -1 -1 74 -1 72 71 72 72 71 72 72 71 72 -1 -1 -1 -1 -1 -1 -1 -1 -1 -1 -1 -1 -1 -1 -1 -1 -1 -1 -1 -1 -1 -1 -1 -1 -1 -1 -1 72 -1
71 72 71 71 72 -1 -1 -1 -1 -1 -1 -1 72 71 72 72 71 72 72 71 72 72 72 72 72 72 71 72 71 72 71 72 72 72 72 71 72 71 72 71 72 -1 72 -1 71 -1 72 71 72 -1
72 72 71 72 72 74 -1 -1 -1 -1 74 -1 72 71 72 72 71 72 72 71 72 71 72 72 72 72 71 72 71 72 71 72 72 72 72 71 72 71 72 71 72 -1 -1 -1 -1 -1 -1 -1 -1 -1
72 71 72 71 71 -1 -1 -1 -1 -1 -1 -1 72 72 71 71 72 71 72 72 71 71 -1 -1 -1 -1 -1 -1 -1 -1 -1 71 71 72 72 71 72 71 72 71 72 71 72 71 71 72 72 71 72 72
72 72 71 72 72 74 -1 -1 -1 -1 74 -1 72 71 72 72 71 72 72 71 72 71 -1 -1 -1 -1 -1 -1 -1 -1 -1 72 72 72 72 71 72 71 72 71 72 71 72 71 71 72 72 71 72 72
71 -1 -1 -1 -1 -1 -1 -1 -1 -1 -1 -1 -1 -1 -1 -1 71 72 71 72 71 72 -1 -1 -1 -1 -1 -1 -1 -1 -1 72 72 72 72 71 72 71 72 71 72 71 72 71 71 72 72 71 72 72
72 -1 -1 -1 -1 -1 -1 -1 -1 -1 -1 -1 -1 -1 -1 -1 72 71 71 72 72 71 -1 -1 -1 -1 -1 -1 -1 -1 -1 72 72 72 72 71 72 71 72 71 72 71 72 71 71 72 72 71 72 72
71 -1 -1 -1 -1 -1 -1 -1 -1 -1 -1 -1 -1 -1 -1 -1 71 72 71 72 71 72 -1 -1 -1 -1 -1 -1 -1 -1 -1 72 72 72 72 71 72 71 72 71 72 71 72 71 71 72 72 71 72 72
72 -1 -1 -1 -1 -1 -1 -1 -1 -1 -1 -1 -1 -1 -1 -1 72 71 71 72 71 71 -1 -1 -1 -1 -1 -1 -1 -1 -1 71 71 72 72 71 72 71 72 71 72 71 72 71 71 72 72 71 72 72
71 -1 -1 -1 -1 -1 -1 -1 -1 -1 -1 -1 -1 -1 -1 -1 -1 -1 -1 -1 -1 -1 -1 -1 -1 -1 -1 -1 -1 -1 -1 72 72 72 72 -1 72 71 72 71 72 71 72 71 71 72 72 71 72 72
72 -1 -1 -1 -1 -1 -1 -1 -1 -1 -1 -1 -1 -1 -1 -1 -1 -1 -1 -1 -1 -1 -1 -1 -1 -1 -1 -1 -1 -1 -1 71 71 72 72 71 72 71 72 71 72 71 72 71 71 72 72 71 72 72
71 -1 -1 -1 -1 -1 -1 -1 -1 -1 -1 -1 -1 -1 -1 -1 -1 -1 -1 -1 -1 -1 -1 -1 -1 -1 -1 -1 -1 -1 -1 72 72 72 72 71 72 -1 72 71 72 71 72 71 71 72 72 71 72 72
71 -1 -1 -1 -1 -1 -1 -1 -1 -1 -1 -1 -1 -1 -1 -1 -1 -1 -1 -1 -1 -1 -1 -1 -1 -1 -1 -1 -1 -1 -1 71 71 72 72 71 72 71 72 71 72 71 72 71 71 72 72 71 72 72
71 -1 -1 -1 -1 -1 -1 -1 -1 -1 -1 -1 -1 -1 -1 -1 71 72 71 72 71 72 -1 -1 -1 -1 -1 -1 -1 -1 -1 71 72 72 72 71 72 71 72 71 72 71 72 71 71 72 72 71 72 72
71 -1 -1 -1 -1 -1 -1 -1 -1 -1 -1 -1 -1 -1 -1 -1 72 71 71 72 71 71 -1 -1 -1 -1 -1 -1 -1 -1 -1 71 72 72 72 71 72 71 72 71 72 71 72 71 71 72 72 71 72 72
71 -1 -1 -1 -1 -1 -1 -1 -1 -1 -1 -1 -1 -1 -1 -1 72 71 71 72 72 71 -1 -1 -1 -1 -1 -1 -1 -1 -1 71 71 72 72 71 72 71 72 71 72 71 72 71 71 72 72 71 72 72
71 -1 -1 -1 -1 -1 -1 -1 -1 -1 -1 -1 -1 -1 -1 -1 71 72 71 72 71 72 -1 -1 -1 -1 -1 -1 -1 -1 -1 71 72 72 72 71 72 71 72 71 72 71 72 71 71 72 72 71 72 72
72 71 71 72 72 72 71 72 71 72 71 72 72 71 71 72 71 72 71 72 71 72 -1 -1 -1 -1 -1 -1 -1 -1 -1 72 -1 72 72 -1 72 71 72 71 72 71 72 71 71 72 72 71 72 72
72 71 71 72 72 72 71 72 71 72 71 72 72 71 71 72 71 72 71 72 71 72 -1 -1 -1 -1 -1 -1 -1 -1 -1 72 72 72 72 71 72 71 72 71 72 71 72 71 71 72 72 71 72 72
71 72 72 72 71 71 72 71 71 71 71 72 71 72 71 72 72 71 71 72 72 71 72 71 72 71 71 72 71 71 72 72 71 72 72 71 72 71 72 71 72 71 72 71 71 72 72 71 72 72
72 71 71 72 72 72 71 72 71 72 71 72 72 71 71 72 71 72 71 72 71 72 72 71 -1 71 72 72 71 71 72 72 71 72 72 71 72 71 72 71 72 71 72 71 71 72 72 71 72 72
71 72 72 72 71 71 72 71 71 71 71 72 71 72 71 72 72 71 71 72 72 71 72 71 71 71 72 72 -1 71 72 72 -1 72 72 71 72 71 72 71 72 71 72 71 71 72 72 71 72 72
72 71 71 72 72 72 71 72 71 72 71 72 72 71 71 72 71 72 71 72 71 72 72 71 72 71 71 72 71 71 72 72 71 72 72 71 72 71 72 71 72 71 72 71 71 72 72 71 72 72
71 72 72 72 71 71 72 71 71 71 71 72 71 72 71 72 72 71 71 72 72 71 72 71 72 71 71 72 71 71 72 72 71 72 72 71 72 71 72 71 72 71 72 71 71 72 72 71 72 72
71 72 72 72 71 71 72 71 71 71 71 72 71 72 71 72 72 71 71 72 72 71 72 71 72 71 71 72 71 71 72 72 71 72 72 71 72 71 72 71 72 71 72 71 71 72 72 71 72 72
-1 -1 -1 -1 -1 -1 -1 -1 -1 -1 -1 -1 -1 -1 -1 -1 -1 -1 -1 -1 -1 -1 -1 -1 -1 -1 -1 -1 -1 -1 -1 -1 -1 -1 -1 -1 -1 -1 -1 -1 -1 -1 -1 -1 -1 -1 -1 -1 -1 -1
<COINS>
20
7 20
6 10
2 9
4 6
16 8
8 25
9 28
8 32
9 35
5 39
24 35
27 31
28 39
8 15
6 38
21 12
21 11
21 10
21 9
21 8
<HERO POS>
1 5
<SNAKES>
20
7 6
10 6
6 11
7 21
8 29
8 26
7 35
10 35
18 35
25 32
24 38
20 10
20 9
20 8
19 10
19 9
19 8
<HEARTS>
10
21 5
21 6
21 7
21 15
21 14
21 13
4 34
4 38
13 34
13 38
27 35
24 30
<ENEMIES>
7
22 10 1
42 24 2
22 35 1
15 35 1
7 33 1
22 15 1
25 17 1